E---------
----------
-XX-------
------XXX-
------XXX-
------XXX-
---N------
----------
XX--------
XX--------